25,25,4
2,2,0,19,16,2,22,1,2,10,1,1,1,18,0,13,18,0,1,10,0,25,25,3
4
4,4,1,5,9,2,8,10,0,9,5,3
8,12,1,8,17,0,13,12,2
11,1,0,11,6,0,14,6,0,14,1,0
21,25,0,25,15,0,21,7,0,16,15,0